PPPPPPPPPPPPPPPPPPPPPPPPPPPPPPPPPPPPPPPPPPPPP
;;;;;;;;;;;;;;;;;;;;;;;;;;;;;;;;;;;;;;;;;;;;;
;;;;;;;;;;;;;;;;;;;;;;;;;;;;;;;;;;;;;;;;;;;;;
;;;;;;;;;;;;;;;;;;;;;;;;;;;;;;;;;;;;;;;;;;;;;
;;;;;;;;;;;;;;;;;;;;;;;;;;;;;;;;;;;;;;;;;;;;;
;;;;;;;;;;;;;;;;;;;;;;;;;;;;;;;;;;;;;;;;;;;;;
;;;;;;;;;;;;;;;;;;;;;;;;;;;;;;;;;;;;;;;;;;;;;
;;;;;;;;;;;;;;;;;;;;;;;;;;;;;;;;;;;;;;;;;;;;;
;;;;;;;;;;;;;;;;;;;;;;;;;;;;;;;;;;;;;;;;;;;;;
;;;;;;;;;;;;;;;;;;;;;;;;;;;;;;;;;;;;;;;;;;;;;
;;;;;;;;;;;;;;;;;;;;;;;;;;;;;;;;;;;;;;;;;;;;;
PPPPPPP;;;PPP;;;;;PPPP;;;;;;;;;;PPP;;;;;;;PPC
PPPPPPP;;;PPP;;;;;PPPP;;;;;;;;;;PPP;;;;;;;PPP
PPPPPPP;;;PPP;;;;;PPPP;;;;;;;;;;PPP;;;;;;;PPP
PPPPPPP;;;PPP;;;;;PPPP;;;;;;;;;;PPP;;;;;;;PPP
PPPPPPP;;;PPP;;;;;PPPP;;;;;;;;;;PPP;;;;;;;PPP
PPPPPPP;;;PPP;;;;;PPPP;;;;;;;;;;PPP;;;;;;;PPP
PPPPPPP;;;PPP;;;;;PPPP;;;;;;;;;;PPP;;;;;;;PPP
PPPPPPP;;;PPP;;;;;PPPP;;;;;;;;;;PPP;;;;;;;PPP
PPPPPPP;;;PPP;;;;;PPPP;;;;;;;;;;PPP;;;;;;;PPP
PPPPPPP;;;PPP;;;;;PPPP;;;;;;;;;;PPP;;;;;;;PPP
PPPPPPP;;;PPP;;;;;PPPP;;;;;;;;;;PPP;;;;;;;PPP
PPPPPPP;;;PPP;;;;;PPPP;;;;;;;;;;PPP;;;;;;;PPP
PPPPPPP;;;PPP;;;;;PPPP;;;;;;;;;;PPP;;;;;;;PPP
PPPPPPP;;;PPP;;;;;PPPP;;;;;;;;;;PPP;;;;;;;PPP
PPPPPPP;;;PPP;;;;;PPPP;;;;;;;;;;PPP;;;;;;;PPP
EEEEEEEEEEEEEEEEEEEEEEEEEEEEEEEEEEEEEEEEEEEEE
